NO ./images/no.xpm
SO ./images/so.xpm
WE ./images/wall_64.xpm
EA ./images/fire_80.xpm


F10,100,20
C 250 , 20,  0



                111 1
    11111111111 1111111111111
    10000000011110000000111111
  1110110010001110000000000001
    1010101000000000000001111111
1111111111E0000000111000000000011 1
11110000001001100000111011111111111
111111111111011111111111111111
   111111000000000000000000001111
1111100001111110111000000100011 1  
1100000111 1000011000000100011111
 1100001011110000111110010001
1100000111 111011111 1111101111
111111111111 10111111111 1001
1111111 111111111111 1111111111