NO ./images/wall1_320.xpm
SO ./images/wall2_320.xpm
WE ./images/wall3_320.xpm
EA ./images/wall4_320.xpm


F 200,200,200
C 8 , 140,  250


11111111111111111111 1111111111111
111111111111011111111111111111111
    10000000011110001000111111111111111111111111111111111111111111111111111111111111111111111111111111111111111111111111111111111111111111111111111111
    11111100000000000000000000000000000000000000000000000000000000000000000000000000000000000000000000000000000000000000000000000000000000000000000001
    11111110000000111000000000000000000000000000000000000000000000000000000000000000000000000000000000000000000000000000000000000000000000000000000001
111111111100000000000000000000000000000000000000000000000000000000000000000000000000000000000000000000000000000000000000000000000000000000000000000001
111100000010000000001110111111111111111111111111111111111111111111111111111111111111111111111111111111111111111111111111111111111111111111111111111111
11111111111100000011111111111111
   1111110000S0000000000000000011
   111111000000000000000000001111
   111111000000000000000000001111
111111100111100001100000100011 1  
111111111111000001000000100001111
 10000000000000000011111000000111
 11111111000000000000000000001111
 11111111000000000000000000001111
111111111011111111111111110001111
100000000011 1011111111111000011
1111111111111111111 11111111111




