NO ./images/fire_20.xpm
SO ./images/fire_40.xpm
WE ./images/fire_60.xpm
EA ./images/fire_80.xpm


F  10,100,20
C 5,30,0


11111111111 1111111111111
1000000000111000000000001
1011000001110000000000001
1001010000000000000000001111111
11111111101100000111000000000011
100000000011000001110111111111111
11110111111111011100000010001
11000000111110111000000100011
1000000001 100001100000010001
100000N001 110000110110010001
110000011111110111110111100111
11110111111101011111111101001
1111111 111111111111 1111111111



