NO ./images/fire_20.xpm
SO ./images/fire_40.xpm
WE ./images/fire_60.xpm
EA ./images/fire_80.xpm


F  10,100,20
C 5,30,0


	11111111111 1111111111111
    10N0000000111000000000001
	10110000011100000000000011
    100101000000000000000001111111
111111111011000001110000000000111
 	   100000000011000001110111111111111
	11110111111111011100000010111
1111100001111111011100000010001 1
1000000001 1000011000000100011111
1000000001 110000110110010001
1100000111111101111101111001111
1111011111	1101011111111101001
1111111 111111111111 1111111111




