NO ./images/wall1_320.xpm
SO ./images/wall2_320.xpm
WE ./images/wall3_320.xpm
EA ./images/wall4_320.xpm


F 200,200,200
C 8 , 140,  250


111111111111111111111111111111
111111111111111111111111111111
    10000000011110001Z0011111111111111111
  111011001000111000100000000000000000001
    10101010000000001N0000000000000000001
11111111110000000111000000000000000000001
11110000001000000000111011111111111111111
111111111111000111111111111111
   111111000000000000000000001111
1111111001111000111000000100011 1  
111111111111000011000000100011111
 1000000000000000011111001000111
11111111111111111111 1111101111
111111111111 1011111111111001
1111111 111111111111 1111111111