NO ./images/no.xpm
SO ./images/so.xpm
WE ./images/we.xpm
EA ./images/ea.xpm


F 255,0,0
C 0 , 0,  255



                111 1
    11111111111 1111111111111
    10000000011110001000111111
  1110110010001110001000000001
    1010101000000000100001111111
1111111111000000011100W000000011 1
11110000001001100000111011111111111
111111111111011111111111111111
   111111000000000000000000001111
1111100001111110111000000100011 1  
1100000111 1000011000000100011111
 1100001011110000111110010001
1100000111 111011111 1111101111
111111111111 10111111111 1001
1111111 111111111111 1111111111