NO ./images/fire_20.xpm
SO ./images/fire_40.xpm
WE ./images/fire_60.xpm
EA ./images/fire_80.xpm


F  10,100,20
C 5,30,0


                111 11 
    11111111111 1111111111111
    1000000001111000000011111
  1110110000001110000000000001
    10101000000000000000001111111
111111111011000001110000000000111
   100000000011000001110111111111111
111111111111011111111111111111
111111000000000000000000001111
11000000111111011100000010001 1
1100000011 1000011000000100011111
 1100N00011110000111110010001
1100000011 111011111 1111101111
111111111111 10111111111 1001
1111111 111111111111 1111111111


