NO ./images/no.xpm
SO ./images/so.xpm
WE ./images/we.xpm
EA ./images/ea.xpm


F 255,250,250
C 0 , 0,  255


111111111111111111111111111111
111111111111111111111111111111
    10000000011110001000111111
  1110110010001110001000000001
    1010101000000000100001111111
11111111110000000111000000000011 1
11110000001001100000111011111111111
111111111111011111111111111111
   111111000000000000000000001111
1111111001111110111000000100011 1  
111111111111000011000000100011111
 1N111100000000000011111001000111
11111111111111111111 1111101111
111111111111 1011111111111001
1111111 111111111111 1111111111