NO ./images/fire_20.xpm
SO ./images/fire_40.xpm
WE ./images/fire_60.xpm
EA ./images/fire_80.xpm


F  10,100,20
C 5,30,0


1111111111111111111111111
1000000000110000000000001
1011000001110000000000001
1001010000000000000000001
111111111011000001110000000000001
100000000011000001110111111111111
11110111111111011100000010001
11000000110101011100000010001
10000000001000001100000010001
100000N000100000110110010001
110000011101010111110111100111
11110111111101011101111010001
11111111111111111111111111111