NO ./images/fire_20.xpm
SO ./images/fire_40.xpm
WE ./images/fire_60.xpm
EA ./images/fire_80.xpm


F10,100,20
C 250 , 20,  0



                111 1
    11111111111 1111111111111
    10000000011110000000111111
  1110110000001110000000000001
    10101000000000000000001111111
111111111101100000111000000000011 1
11110000000001100000111011111111111
111111111111011111111111111111
   111111000000000000000000001111
1111100001111110111000000100011 1  
1100000011 1000011000000100011111
 1100N00011110000111110010001
1100000011 111011111 1111101111
111111111111 10111111111 1001
1111111 111111111111 1111111111